Aadland, Edith	Infinity
Aadland, Florence	Infinity
Aadland, Lauren	Infinity
Aadli, Myriam	Infinity
Aadussoo, Liisa	Infinity
Aae, Nina	Infinity
Aafer, Yasmine	Infinity
Aafif, Samia	Infinity
Aaftink, Sandra	Infinity
Aagaard Gamlund, Karoline	Infinity
Aagaard, Clara	Infinity
Aagaard, Daniella (I)	Infinity
Aagaard, Dorit	Infinity
Aagaard, Frederikke	Infinity
Aagaard, Gudrun Harboe	Infinity
Aagaard, Ita	Infinity
Aagaard, Jane	1
Bacon, Kevin (I)	0
De Niro, Robert	1
Reiner, Robb	1
Sheen, Charlie	1
Travolta, John (I)	1
Wilson, Owen (I)	1
Aagaard, Julie	Infinity
Aagaard, Laura	Infinity
Aagaard, Lis	Infinity
Aagaard, Lise	Infinity
Aagaard, Patti	Infinity
Aagaard, Rie	Infinity
Aagaard, Vanessa	Infinity
Aagaard, Vibeke	Infinity
Aagaard, Åse Kristin	Infinity
Aagaard-Hansen, Simone	Infinity
Aagard, Heather	Infinity
Aagedal, Liv Torunn	Infinity
Aagesen, Hanne	Infinity
Aagesen, Kathryn	Infinity
Aagha, Sasha	Infinity
Bassey, Jennifer (I)	1
Dunst, Kirsten	1
Sarandon, Susan	1
Reiner, Rob	1
Sheen, Michael (I)	1
Travolta, Joey (I)	1
Hunter, Holly (I)	1
Loren, Sophia	1
Loring, Lisa	1
Stowe, Madeleine	1
Winslet, Kate	1
Wood, Lana (I)	1
Wood, Natalie (I)	1
Zellweger, Renée	1
Allen, Woody	1
Ford, Harrison (I)	1
Kinnear, Greg (I)	1
Lewis, Richard (II)	1
Shatner, William	1
Sheen, Martin	1
Wood, Lindy	2
Winston, Dayna (I)	2
Winston, Connie	2
Matthes, Charlie	1
Silver, Ron (I)	1
Hursey, Sherry (I)	2
Loring, Gloria	1
Weaver, Sigourney	1
Winston, Hattie	1
Russo, Rene	1
Ryder, Winona	1
Cumming, Alan	1
Bassey, Shirley	1
Matthau, Walter	1
Sheen, Fulton J.	1
Bassey, Lucy	Infinity
Bassey, Michaella	Infinity
Bassey, Nene	Infinity
Bassey, Patience	Infinity
Sheene, Barry	2
Weaving, Hugo	1
Bacon, Max	2
Matthew, Brian	2
Ryder, Anne	2
Bacon, Michael (I)	1
Hunter, Alberta	1
Matthau, Charles	1
Dunst, Inez	Infinity
Dunst, Irmchen	Infinity
Judge, Mike (I)	1
Ryder, Penny	2
Ryder, Serena	1
Matthew, Bernie	1
Travolta, Jett	1
Hamilton, Aidan	2
Ryder, Carly	1
Nicosia, Liam	1
Wood, Natalie (II)	2
Dunstan, Amberly	Infinity
Dunstan, Amy Hayashi	Infinity
Dunstan, Dorothea	Infinity
Dunstan, Elaine	2
Dunstan, Jennifer	Infinity
Furlan, Mira	Infinity
Garay, Soo	2
Ryder, Lisa (I)	2
Bacon, Patrick	2
Judge, Paul (I)	2
Hunter, Adina R.	Infinity
Hunter, Adrienne	Infinity
Hunter, Alana	Infinity
Shatnyski, Steve	2
Gossett, Mitchell (I)	3
Ryder, Amy (I)	2
Hamilton, Murray (I)	1
Wong, Noua	2
Wood, Lauren (I)	2
Wittman, Rachel	2
Ryder, Nanci	1
Loring, Hope	Infinity
Loring, Jade	Infinity
Loring, Janelle	Infinity
Loring, Jessica (II)	Infinity
Loring, Jeana	Infinity
Loring, Jeanne F.	Infinity
Loring, Jennifer	Infinity
Loring, Jessica (I)	Infinity
Loring, Jill	Infinity
Loring, Kay	Infinity
Russo, Regina	Infinity
Russo, Sydney (I)	Infinity
Ryder, Abbey	Infinity
Ryder, Addison	Infinity
Ryder, Chase	Infinity
Ryder, Dylan	Infinity
Ryder, Alana	Infinity
Ryder, Olivia	Infinity
Ryder, Rina	Infinity
Ryder, Sheena	Infinity
Ryder, Alexandra (II)	Infinity
Ryder, Alice-Rose (II)	Infinity
Ryder, Andrea (I)	Infinity
Ryder, Andrea (II)	Infinity
Judge, Onkar	Infinity
Ryder, Angela	3
Nicolson, Paul	2
Ryder, Anna (II)	Infinity
Ryder, Ava	Infinity
Ryder, Apryl	Infinity
Ryder, Aurelia	Infinity
Ryder, Bailey	Infinity
Ryder, Brandy	Infinity
Ryder, Bri	Infinity
Ryder, Brianna	Infinity
Ryder, Bridgette	Infinity
Ryder, Richelle	Infinity
Ryder, C.C. (I)	Infinity
Ryder, Caroline (I)	3
Wood, Lisa (I)	3
Wood, Lucy (I)	3
Matthes, Ulrich	3
Nicolson, Steve	2
Ryder, Cassie	Infinity
Ryder, Celia	3
Ryder, Nanette	3
Ryder, Chandra	Infinity
Ryder, Shayne (I)	Infinity
Ryder, Christy	Infinity
Ryder, Claire	Infinity
Ryder, Cody	Infinity
Ryder, Debbie (I)	Infinity
Ryder, Diane (I)	Infinity
Ryder, Donna	Infinity
Ryder, Dusty	Infinity
Ryder, Roxie	Infinity
Ryder, Gina (I)	Infinity
Ryder, Emma (II)	Infinity
Ryder, Erin	2
Ryder, Felecia	Infinity
Ryder, Fiona (I)	Infinity
Ryder, Geneva	Infinity
Ryder, Gina (II)	Infinity
Ryder, Grace	Infinity
Ryder, Harlee	Infinity
Ryder, Harriet	Infinity
Ryder, Heidi	Infinity
Ryder, Holly	Infinity
Ryder, Joy	Infinity
Ryder, Irene	Infinity
Ryder, Izzi	Infinity
Ryder, Jan	Infinity
Ryder, Jane	Infinity
Ryder, Janet	2
Wood, Leanne	2
Nicolson, John	2
Ryder, Jazmine	Infinity
Ryder, Jenny	Infinity
Ryder, Jessica (I)	Infinity
Ryder, Jessica (II)	Infinity
Ryder, Jizzelle	Infinity
Ryder, Joanne	Infinity
Ryder, Jodi	Infinity
Ryder, K.K.	Infinity
Ryder, Kailie	Infinity
Ryder, Karly	Infinity
Ryder, Kate	Infinity
Ryder, Katrina	Infinity
Ryder, Kealy	Infinity
Ryder, Kelly	3
Bacon, Nick (I)	2
Ryder, Kim	Infinity
Ryder, Kimberly	Infinity
Ryder, Kristin	2
Ryder, MiMi	2
Ryder, Talia	2
Ryder, Kylie	Infinity
Ryder, Lauren	2
Ryder, Leah	Infinity
Ryder, Lexi	Infinity
Ryder, Romana	Infinity
Ryder, Rebecca (I)	Infinity
Ryder, Robin	Infinity
Ryder, Liz	Infinity
Ryder, Lorraine	Infinity
Ryder, Lylah	Infinity
Ryder, Maggie	4
Bacon, Norman	3
Ryder, Maria (II)	Infinity
Ryder, Marianne	Infinity
Ryder, Mary (I)	3
Ryder, Mary (II)	Infinity
Ryder, Mary Jo	Infinity
Ryder, Melanie	Infinity
Ryder, Mia (I)	Infinity
Ryder, Mila	Infinity
Ryder, Molly	2
Reiner, Robert (I)	2
Ryder, Monika	Infinity
Wood, Lisa (II)	4
Ryder, Natalie (I)	Infinity
Ryder, Natalie (II)	Infinity
Ryder, Paisly	Infinity
Ryder, Patricia	Infinity
Bacon, Martin	3
Ryder, Rachel	Infinity
Ryder, Randy (I)	Infinity
Ryder, Rebecca (II)	Infinity
Ryder, Riley	Infinity
Ryder, Rita	Infinity
Ryder, Roc	2
Matthew Sr., Jesse	2
Ryder, Rochelle	Infinity
Ryder, Rose	Infinity
Ryder, Roxy (II)	Infinity
Ryder, Ruby	Infinity
Ryder, Ryen	Infinity
Ryder, Sarah (II)	Infinity
Ryder, Savannah	Infinity
Ryder, Sebastian	Infinity
Sheepdogs, The	2
Ryder, Shyla	Infinity
Ryder, Slone	Infinity
Ryder, Sue	Infinity
Ryder, Susan (II)	Infinity
Ryder, Suzanne	Infinity
Ryder, Sylvia	Infinity
Ryder, Syntrell	Infinity
Ryder, Tieira	Infinity
Winston, Etta	Infinity
Ryder, Tieria	Infinity
Ryder, Tina	Infinity
Ryder, Vicki	Infinity
Ryder, Violet	Infinity
Sheen, Bob	2
Sheen, Max	2
Sarandon, Alexis	Infinity
Hamilton, Aaron (I)	2
Yu, Nan (I)	2
Nicomede, Dennis	2
Stowe, Barbara (II)	Infinity
Stowe, Carmen	Infinity
Stowe, Chelsea	Infinity
Stowe, Ciel	Infinity
Stowe, Emily	Infinity
Stowe, Jane	Infinity
Stowe, Jennifer	Infinity
Yagi, Masako (I)	2
Winslet, Anna	Infinity
Winslet, Beth	2
Matthew (XIX)	2
Reiners, Ed	2
Winston, Crystal 'Toi'	Infinity
Winston, Debbie	Infinity
Winston, Edna	Infinity
Winston, Ellen	Infinity
Winston, Florence	Infinity
Gossett, Deondray	2
Winston, Heidi	2
Wittman, Mary Lou	Infinity
Wittman, Meg	Infinity
Wittman, Micaela	2
Wittman, Priscilla	Infinity
Wood, Laura (VIII)	Infinity
Wittman-McChesney, Matisse	Infinity
Wittmann, Anaïse	Infinity
Wittmann, Barbara	Infinity
Wittmann, Carola	Infinity
Wittmann, Charlotte	Infinity
Wittmann, Doris	Infinity
Wittmann, Erika	Infinity
Wittmann, Fran	Infinity
Wittmann, Frauke	Infinity
Wittmann, Helena	Infinity
Wittmann, Ingeborg	Infinity
Wittmann, Sabrina Andrea	Infinity
Wittmann, Samantha	Infinity
Wittmann, Sascha	Infinity
Wittmann, Stephanie	Infinity
Wittmann, Tanja	Infinity
Wittmer, Mary Lou	Infinity
Wittmer, Sophie	Infinity
Wittmeyer, Jennifer	Infinity
Wittmeyer, Kaylin	Infinity
Wittner, Floreanita	Infinity
Wong, Nga-Man	Infinity
Wong, Ngai-Yee	Infinity
Yu, Mo-Lin	Infinity
Wong, Nicole (I)	Infinity
Wong, Nikki (I)	Infinity
Wong, Ning	Infinity
Wong, Nisa	Infinity
Wong, Oi Ming	Infinity
Sheep, Smile White	2
Wood, Lana (III)	Infinity
Wood, Lana Destiny	Infinity
Wood, Latisha	Infinity
Wood, Laura (I)	2
Wood, Laura (II)	Infinity
Wood, Laura (IV)	Infinity
Wood, Laura (IX)	Infinity
Wood, Laura (VI)	Infinity
Wood, Laura (XI)	Infinity
Wood, Laura (XII)	Infinity
Wood, Laura (XIV)	Infinity
Wood, Laura E.	Infinity
Wood, Lauren (II)	Infinity
Wood, Lauren (VIII)	Infinity
Wood, Lauren Alexis	Infinity
Wood, Lauren alexis	Infinity
Wood, Lauren Charmain	Infinity
Judge, Seán Patrick	Infinity
Wood, Lauren K.	Infinity
Wood, Lauren Mitte	Infinity
Wood, Lauren S.	Infinity
Wood, Laurie (I)	Infinity
Wood, Lauryn	Infinity
Wood, Laylani	Infinity
Wood, Leah (I)	Infinity
Wood, Leanda	Infinity
Wood, Leigh	Infinity
Wood, Leinani	Infinity
Wood, Lesa	Infinity
Wood, Lesia	Infinity
Wood, Lesley (II)	Infinity
Wood, Leslie (IX)	Infinity
Wood, Leslie (VIII)	Infinity
Wood, Leslie (X)	Infinity
Wood, Lexcee	Infinity
Wood, Lexi (II)	Infinity
Wood, Libby	Infinity
Wood, Lilith	Infinity
Wood, Lily	Infinity
Wood, Linda J.	Infinity
Wood, Linn	Infinity
Wood, Lisa (V)	Infinity
Wood, Lisa (VII)	Infinity
Wood, Lisa (X)	Infinity
Wood, Liz (I)	Infinity
Wood, Liz (II)	4
Wood, Lizzie	Infinity
Wood, Lois	Infinity
Wood, Lorna (I)	Infinity
Wood, Louise (III)	Infinity
Wood, Lucy (V)	Infinity
Wood, Lucy (X)	Infinity
Wood, Lucy Rose	Infinity
Wood, Lyla	Infinity
Wood, Lyn (II)	Infinity
Wood, Lyn (III)	Infinity
Yagi, Michiyo	Infinity
Yagi, Miyuki	Infinity
Yagi, Nanaka	Infinity
Yagi, Nozomi	Infinity
Yagi, Rikako	Infinity
Yagi, Sachiko	Infinity
Yagi, Saori	Infinity
Yagi, Saroko	Infinity
Yagi, Shizuko	Infinity
Yagi, Sonja	Infinity
Yagi, Takako	Infinity
Yagi, Tamie	Infinity
Yagi, Teruko	Infinity
Yagi, Toshiko	Infinity
Yagi, Yuka	Infinity
Yagi, Yûki	Infinity
Yu, Michelle (II)	Infinity
Yu, Michelle (IV)	Infinity
Yu, Michelle S.	Infinity
Yu, Mimi	Infinity
Yu, Min (IV)	Infinity
Yu, Min (V)	Infinity
Yu, Ming (II)	Infinity
Yu, Ming-jia	Infinity
Yu, Ming-Sao	Infinity
Yu, Monica (II)	Infinity
Yu, Mu-Ying	Infinity
Yu, Mung	Infinity
Yu, Muzi	Infinity
Yu, Myeong-wan	Infinity
Yu, Na	Infinity
Yu, Na-mi	Infinity
Yu, Na-yeong	Infinity
Yu, Nami	Infinity
Yu, Nancy (III)	Infinity
Yu, Nanhee	Infinity
Yu, Ning	Infinity
Yu, Niu	Infinity
Yu, Niya	Infinity
Yu, Nuo	Infinity
Yu, Ofelia	Infinity
Yu, Olive	Infinity
Yu, On-On	Infinity
Zagorsky, Kyra	Infinity
Zagoruyko, Eugenia	Infinity
Zagory, Ellen	Infinity
Zagoul, Penelope	Infinity
Zagozda, Tammie	Infinity
Zagozodneva, Anna	Infinity
Zagra, Liliana	Infinity
Zagrebelnaya, Tatyana	Infinity
Zagrebina, Irina	Infinity
Zagrecki, Paula	Infinity
Zagreda, Elza	2
Judge-Russo, Jonathan	2
Allen, Wyatt	Infinity
Allen, Wylie	Infinity
Allen, Wyllie	Infinity
Allen, Wynn	Infinity
Allen, Wynter	Infinity
Allen, Xander	Infinity
Allen, Xander J.	Infinity
Bacon, Neal	1
Bacon, Kevin (VII)	Infinity
Bacon, Kristin	Infinity
Bacon, Larry	Infinity
Bacon, Les	Infinity
Bacon, Lewis	Infinity
Bacon, Lloyd	Infinity
Bacon, Luke	Infinity
Bacon, Mace	Infinity
Bacon, Marco	Infinity
Bacon, Marcus	Infinity
Bacon, Margaret (III)	Infinity
Bacon, Mario	Infinity
Bacon, Matt (III)	Infinity
Bacon, Matt (IV)	Infinity
Bacon, Maurice	Infinity
Bacon, Mavis	Infinity
Bacon, Merced (I)	Infinity
Bacon, Michael (V)	Infinity
Bacon, Michael (VIII)	Infinity
Bacon, Michelle	Infinity
Bacon, Miles	Infinity
Bacon, Monique	Infinity
Bacon, Myles	Infinity
Bacon, Nathan	Infinity
Bacon, Nathaniel (I)	Infinity
Bacon, Nick (II)	Infinity
Bacon, Nick (IV)	Infinity
Bacon, Nick (III)	Infinity
Bacon, Nicky Daniel	Infinity
Bacon, Oscar	Infinity
Beejoir	Infinity
Beejun, Ted C.	Infinity
Beek, Bart	Infinity
Beek, Blake Van	Infinity
Beek, Randall	Infinity
Beek, Reitse	Infinity
Beek, Richard (I)	3
Reiner, Thomas	3
Reiners, Florian (I)	3
Reiners, Rainer	2
Matthes, Dieter	3
Reinert, Hans-Jürgen	3
Cumming, Aaron (II)	Infinity
Cumming, Aaron (III)	Infinity
Cumming, Ace	Infinity
Judge, Philip	2
Cumming, Alec	Infinity
De Niro, G.	Infinity
De Niro, Joel	Infinity
de Niro, José Antonio	Infinity
De Niro, Julian	Infinity
De Niro, Max	Infinity
De Niro, Raphael	2
Judge, Mychal	2
Nicolás, Miguel Ángel	2
De Niro, Rocco	Infinity
De Niro, Tony	Infinity
Ford, Harrison (II)	Infinity
Gossett, Adam	Infinity
Gossett, Andrew	Infinity
Gossett, Matt (I)	Infinity
Gossett, Anthony	Infinity
Gossett, Bob (I)	Infinity
Gossett, Brandon	Infinity
Gossett, Brian	Infinity
Gossett, Bruce	Infinity
Gossett, Jeff	Infinity
Gossett, Charles	Infinity
Gossett, Christian	Infinity
Gossett, Dallas (I)	Infinity
Gossett, Dallas (II)	Infinity
Gossett, David	Infinity
Gossett, Dion	Infinity
Gossett, Jim (II)	Infinity
Gossett, Joel	Infinity
Gossett, Joey	Infinity
Gossett, Kyle	Infinity
Gossett, Larry	Infinity
Gossett, Marcel (II)	Infinity
Gossett, Mark	Infinity
Gossett, Martin	Infinity
Gossett, Michael	Infinity
Gossett, Mike	Infinity
Gossett, Mitchell (III)	Infinity
Hamilton, 'Doc' John	Infinity
Hamilton, Aaron 'Rocky'	Infinity
Hamilton, Adam (I)	Infinity
Hamilton, Adam (II)	Infinity
Hamilton, Adam (IV)	Infinity
Hamilton, Adam (V)	Infinity
Hamilton, Adam Alexander	Infinity
Hamilton, Adam Lee	Infinity
Hamilton, Afraizh Rowland	Infinity
Hamilton, Aj	Infinity
Hamilton, Al (III)	Infinity
Hamilton, Alan (I)	Infinity
Hamilton, Alan (II)	Infinity
Hamilton, Alan (V)	Infinity
Hamilton, Alan (VI)	2
Hamilton, Alex (I)	Infinity
Hamilton, Alex (II)	Infinity
Hamilton, Alex (VI)	Infinity
Hamilton, Nash	Infinity
Hamilton, Nate	Infinity
Hamilton, Nathan (I)	Infinity
Judge, Mike (III)	Infinity
Judge, Oliver	Infinity
Judge, Owen	Infinity
Judge, Pat	Infinity
Judge, Paul (III)	2
Judge, Paul (IV)	Infinity
Judge, Phil	Infinity
Judge, Sam	Infinity
Judge, Samantha (II)	Infinity
Judge, Todd A.	Infinity
Judge, Tony (I)	Infinity
Judge, Tony (II)	Infinity
Judge, William C.	Infinity
Judge, Willy	Infinity
Judge, Zico (I)	Infinity
Judgefield, M.J.	2
Judgefield, Martin J.	3
Judges, Christopher	Infinity
Judges, Gord	Infinity
Judges, John	Infinity
Judges, Lyndal	Infinity
Judi, Alexander	Infinity
Kinnear, Jason	Infinity
Kinnear, Jeremy	Infinity
Kinnear, Jim	Infinity
Kinnear, Joe (I)	Infinity
Sheepshanks, David	Infinity
Kinnear, Keenan	Infinity
Matthau, David	2
Matthaus, Ralph	Infinity
Mattheeuws, Bart	Infinity
Mattheeuwsen, Ferri	Infinity
Matthei, Phil	Infinity
Matthei, Ross	Infinity
Mattheis, Eddie	Infinity
Mattheis, Jeremy	Infinity
Mattheis, Kaiki	Infinity
Mattheis, Philipp	Infinity
Mattheogiannis, Panos	Infinity
Mattheos, Ermolaos	Infinity
Mattheou, Giorgos	Infinity
Mattheou, Panagiotis	Infinity
Matther, Hermann	Infinity
Matthes, Jim	2
Matthes, Claus	Infinity
Matthes, Daniel	Infinity
Matthes, Dave	Infinity
Matthes, David	Infinity
Matthes, Fred	Infinity
Matthes, Gerd	Infinity
Matthes, Günter	Infinity
Matthes, Günther	Infinity
Matthes, Heiner	Infinity
Matthes, John	Infinity
Matthes, Jonas	4
Matthes, Marco	Infinity
Matthes, Merlin	Infinity
Matthes, Taliesin	Infinity
Matthes, Roland	Infinity
Matthes, Walter	Infinity
Matthesen, Anders	2
Mattheu, Lee	Infinity
Mattheus, Marcial	Infinity
Mattheus, Ronny	Infinity
Mattheus, Ryan	Infinity
Matthew (I)	Infinity
Matthew (IV)	Infinity
Matthew (IX)	Infinity
Matthew (V)	Infinity
Matthew (VIII)	Infinity
Matthew (X)	Infinity
Matthew (XI)	Infinity
Matthew (XII)	Infinity
Matthew (XIV)	Infinity
Matthew (XV)	Infinity
Matthew (XVI)	Infinity
Matthew (XXII)	Infinity
Matthew (XXIX)	Infinity
Matthew (XXV)	Infinity
Matthew (XXVIII)	Infinity
Matthew (XXXII)	Infinity
Matthew (XXXIII)	Infinity
Matthew (XXXIV)	Infinity
Matthew (XXXVI)	Infinity
Matthew Bonnell	Infinity
Matthew Fordham	Infinity
Matthew, Aaron	Infinity
Matthew, Abe	Infinity
Matthew, Adam	Infinity
Matthew, Adam Lee	Infinity
Matthew, Aiden (I)	Infinity
Matthew, Al	Infinity
Matthew, Alan	Infinity
Matthew, Alexander (I)	Infinity
Matthew, Alexander (II)	Infinity
Matthew, Allison	Infinity
Matthew, Ashvin	Infinity
Matthew, Bicco	Infinity
Matthew, Bijin	Infinity
Matthew, Brennan	Infinity
Matthew, Cameron	Infinity
Matthew, Chris (II)	Infinity
Nicolson, Alasdair (II)	Infinity
Nicolson, Alex	Infinity
Nicolson, Andy	Infinity
Nicolson, Angus	Infinity
Nicolson, Chloe	Infinity
Nicolson, Christian	Infinity
Nicolson, Colin (I)	Infinity
Nicolson, Colin (II)	Infinity
Nicolson, Colin (III)	Infinity
Nicolson, Dave	Infinity
Nicolson, David (I)	Infinity
Nicolson, Earl	Infinity
Nicolson, Ellis	Infinity
Nicolson, Grant	Infinity
Nicolson, Harold	Infinity
Nicolson, Huata	Infinity
Nicolson, Hugh (I)	Infinity
Nicolson, Iain	Infinity
Nicolson, Jonathan	Infinity
Nicolson, Ken	Infinity
Nicolson, Logan J.	Infinity
Nicolson, Mark	Infinity
Nicolson, Max (I)	Infinity
Nicolson, Nigel	Infinity
Nicolson, Richard	Infinity
Nicolson, Robert (II)	Infinity
Nicolson, Roderick	Infinity
Nicolson, Shawn	Infinity
Nicoltzeff, Alec	Infinity
Nicolucci, Fabio	Infinity
Nicolussi, Martin	Infinity
Nicolussi, Max	Infinity
Nicoly, Antonio	Infinity
Nicolàs, Joan	Infinity
Nicolás	Infinity
Nicolás Delgado, Javier	Infinity
Nicolás Moreno, Fernando	Infinity
Nicolás, Alberto	Infinity
Nicolás, Andres	Infinity
Nicolás, Angel	Infinity
Nicolás, Camilo	Infinity
Nicolás, Francisco	Infinity
Nicolás, Gabi	Infinity
Nicolás, Gabriel	Infinity
Nicolás, Ignacio	Infinity
Nicolás, Joaquín Luis	Infinity
Nicolás, José Manuel López	Infinity
Nicolás, Juan San	Infinity
Nicolás, Leandro	Infinity
Nicolás, Mar	Infinity
Nicolás, Maykel Mario	Infinity
Nicolás, Miguel Ángel López	Infinity
Nicolás, Ramón (II)	Infinity
Nicolás, Ángel	Infinity
Nicosia, Joseph	3
Nicomedes, Cedric	Infinity
Nicomedes, Orlando	Infinity
Nicor, Michael	Infinity
Nicora, Alfredo	Infinity
Nicora, Curt	Infinity
Nicora, Davide (I)	Infinity
Nicora, Luca	Infinity
Nicora, Rodrigo (I)	Infinity
Nicos	Infinity
Nicos, Antoine	Infinity
Nicosi, Aeris	Infinity
Nicosia, Adriano (I)	Infinity
Nicosia, Albert	Infinity
Nicosia, Alessandro	Infinity
Nicosia, Alexander	Infinity
Nicosia, Anthony	Infinity
Nicosia, Carmelo	Infinity
Nicosia, David	Infinity
Nicosia, Elia	Infinity
Nicosia, Frank	Infinity
Nicosia, Jake	Infinity
Nicosia, Joe (I)	Infinity
Nicosia, John	Infinity
Nicosia, Joseph A.	2
Nicosia, Joshua	Infinity
Nicosia, Len	Infinity
Nicosia, Mike	Infinity
Nicosia, Mario	Infinity
Nicosia, Mark (I)	Infinity
Nicosia, Mark (II)	Infinity
Nicosia, Massimiliano	Infinity
Nicosia, Miguel	Infinity
Nicosia, Mojoe	2
Nicosia, Paolo	Infinity
Reiner, Tyler	2
Sheen, Kevin (I)	2
Reiner, Robert (II)	Infinity
Reiner, Sarah Jane	Infinity
Reiner, Shep	Infinity
Reiner, Steve	Infinity
Reiner, Tamas	Infinity
Reiner, Thomas Robert	Infinity
Reiner, Victoria	Infinity
Reiner, William	Infinity
Reiner, Zach (I)	Infinity
Reiner-Halm, Georg	Infinity
Reinero, Bryan	Infinity
Reinero, Joseph	Infinity
Reinero, Michael	Infinity
Reiners, Ashley	Infinity
Reiners, Dan	Infinity
Reiners, Dennis	Infinity
Reiners, Deànré	Infinity
Reiners, Florian (II)	Infinity
Reiners, Hans	Infinity
Reiners, Jörn	Infinity
Reiners, Kai	Infinity
Reiners, Randy	Infinity
Reiners, Till	Infinity
Reinert Jr., Robert	Infinity
Reinert, Anthony	Infinity
Reinert, Bill	2
Reinert, Brad	Infinity
Reinert, Joey	Infinity
Reinert, Eric	Infinity
Reinert, Erik	Infinity
Reinert, Hans-J.	Infinity
Reinert, Henrik	Infinity
Reinert, Jason (II)	Infinity
Reinert, Karl Marcus	Infinity
Reinert, Karl Markus	Infinity
Shatner, James T.	Infinity
Shato	Infinity
Shatoff, Jonathan	Infinity
Shatokhin, Aleksandr	Infinity
Shatokhin, Artem	Infinity
Shatokhin, Grigoriy	Infinity
Shatokhin, I.	Infinity
Shatokhin, Nikolai (I)	Infinity
Shatov, Aleksandr	Infinity
Shatov, Oleg	Infinity
Shatovsky, Alberto	Infinity
Sheen, Alan	3
Sheen, Chris (II)	Infinity
Sheen, Daniel	Infinity
Sheen, David (I)	Infinity
Sheen, David (II)	Infinity
Sheen, David (III)	Infinity
Sheen, David K.	Infinity
Sheen, Derek	Infinity
Sheen, Erick	Infinity
Sheen, Greg	Infinity
Sheen, Guy	Infinity
Sheen, Jacob	Infinity
Sheen, Jay	Infinity
Sheen, Jeramiah	Infinity
Sheen, Jillian	Infinity
Sheen, Kevin (II)	Infinity
Sheen, Leon	Infinity
Sheen, Lih Hwa	Infinity
Sheen, Lily	Infinity
Sheen, Paul (I)	Infinity
Sheen, Pippa	Infinity
Sheen, Ray (I)	Infinity
Sheen, Ray (II)	Infinity
Sheen, Russell	Infinity
Sheen, Steve	Infinity
Sheen, Ty	Infinity
Sheen-Stevens, James	Infinity
Sheena (XXI)	Infinity
Sheenan, Eddie	Infinity
Sheenan, Frank	Infinity
Sheenan, James	Infinity
Sheenan, John J.	Infinity
Sheenan, Kevan	Infinity
Sheenan, Zachary	Infinity
Sheene, Grace	Infinity
Sheene, Todd	Infinity
Sheene, Tony	Infinity
Sheenhan, Staff	Infinity
Sheeno, Ramsen	Infinity
Sheens, Nathan	Infinity
Sheens, Rob	Infinity
Sheens, Tim	Infinity
Sheep (II)	Infinity
Sheep, Boris the	Infinity
Sheep, Marble	Infinity
Sheepe, Jack	Infinity
Sheepers, Ron	Infinity
Sheeple, Bird	Infinity
Sheepshanks, Andrew	Infinity
Sheer, Andrew	Infinity
Travis, Will	Infinity
Travolta, Brian	Infinity
Travolta, Dragisa Markovic	Infinity
Travolta, Sam	2
Travolta, Joey (II)	Infinity
Travolta, John (II)	Infinity
Travolta, Rikki Lee	Infinity
Travoltas, The	Infinity
Travone, Jerry	Infinity
Travor, Valter	Infinity
Travossos, Steven	Infinity
Travostino, Gigi	Infinity
Travostino, Tony	Infinity
Trawally, Boone	Infinity
Trawally, Mohammed	Infinity
Trawbridge, Derek	Infinity
Traweek-Till, Geoffrey	Infinity
Trawick, Bryan	Infinity
Trawick, Brynden	Infinity
Weaving, James	Infinity
Weaving, Jon	Infinity
Weaving, Simon	Infinity
Web (II)	Infinity
Web (III)	Infinity
Web, Arngod	Infinity
Web, Ben	Infinity
Web, Bruce	Infinity
Web, Jason (I)	Infinity
Web, Jen	Infinity
Web, Marek	Infinity
Web, Steve	Infinity
Web, Tim	Infinity
Web, Tom	Infinity
Wilson, Ozell	Infinity
Wilson, P.H. St John	Infinity
Wilson, Paddy (I)	Infinity
Wilson, Page Peter	Infinity
Wilson, Paketo	Infinity
